111111111111111111111111
100000000000000000000001
100000000000000000000001
100000000000000000000001
100000000000000000000001
100000000000000000000001
100000000000000000000001
100000000000000000000001
100000000000000000000001
100000001000000000000001
100000001110000000000001
100000000011000000000001
100110000000000000000001
100011100000000000000001
100000000000000000000001
110000000000000000000001
100000010000000000000001
100000110000000000000001
100011000000000000000001
100000000000000000000001
100000000000000000000001
10P000000000000000000001
100000000000000000000001
111111111111111111111111